AL | Alabama | America/Chicago
AK | Alaska | America/Adak | America/Anchorage | America/Juneau | America/Nome | America/Yakutat
AZ | Arizona | America/Phoenix | America/Shiprock
AR | Arkansas | America/Chicago
CA | California | America/Denver | America/Los_Angeles
CO | Colorado | America/Denver
CT | Connecticut | America/New_York
DE | Delaware | America/New_York
DC | District of Columbia | America/New_York
FL | Florida | America/New_York
GA | Georgia | America/New_York
HI | Hawaii | Pacific/Honolulu
HI | Honolulu | Pacific/Honolulu
ID | Idaho | America/Boise | America/Denver | America/Los_Angeles
IL | Illinois | America/Chicago
IN | Indiana | America/New_York | America/Indiana/Indianapolis | America/Indiana/Knox | America/Indiana/Marengo | America/Indiana/Petersburg | America/Indiana/Vevay | America/Indiana/Vincennes |America/Indiana/Winamac
IA | Iowa | America/Chicago
KS | Kansas | America/Denver
KY | Kentucky | America/New_York | America/Kentucky/Louisville | America/Kentucky/Monticello
LA | Louisiana | America/Chicago
ME | Maine | America/New_York
MD | Maryland | America/New_York
MA | Massachusetts | America/New_York
MI | Michigan | America/Detroit
MN | Minnesota | America/Chicago
MS | Mississippi | America/Chicago
MO | Missouri | America/Chicago
MT | Montana | America/Denver
NE | Nebraska | America/Denver
NV | Nevada | America/Denver | America/Los_Angeles
NH | New Hampshire | America/New_York
NJ | New Jersey | America/New_York
NM | New Mexico | America/Denver | America/Shiprock
NY | New York | America/New_York
NC | North Carolina | America/New_York
ND | North Dakota | America/Denver | America/North_Dakota/Center
OH | Ohio | America/New_York
OK | Oklahoma | America/Chicago
OR | Oregon | America/Boise | America/Denver | America/Los_Angeles
PA | Pennsylvania | America/New_York
RI | Rhode Island | America/New_York
SC | South Carolina | America/New_York
SD | South Dakota | America/Chicago | America/Denver
TN | Tennessee | America/New_York
TX | Texas | America/Denver
UT | Utah | America/Denver
VT | Vermont | America/New_York
VA | Virginia | America/New_York
WA | Washington | America/Denver | America/Los_Angeles
WV | West Virginia | America/New_York
WI | Wisconsin | America/Chicago | America/Menominee
WY | Wyoming | America/Denver
